2,2,2,2,2,2,2,2,2,2,2,2,2,2,2,2,2,2,2,2
2,2,2,2,2,2,2,2,2,2,2,2,2,2,2,2,2,2,2,2
2,2,2,2,2,2,2,2,2,2,2,2,2,2,2,2,2,2,2,2
2,2,2,2,2,2,2,2,2,2,2,2,2,2,2,2,2,2,2,2
2,2,2,2,2,2,2,0,4,4,4,0,2,2,2,2,2,2,2,2
2,2,2,2,2,2,2,1,4,4,4,1,2,2,2,2,2,2,2,2
2,2,2,2,2,2,2,4,4,4,4,4,2,2,2,2,2,2,2,2
2,2,2,2,2,2,2,4,4,3,4,4,2,2,2,2,2,2,2,2
2,2,2,2,2,2,2,4,4,4,4,4,2,2,2,2,2,2,2,2
2,2,2,2,2,2,2,4,4,4,4,4,2,2,2,2,2,2,2,2
2,2,2,2,2,2,2,4,4,4,4,4,2,2,2,2,2,2,2,2
2,2,2,2,2,2,2,0,1,4,1,0,2,2,2,2,2,2,2,2
2,2,2,2,2,2,2,2,2,2,2,2,2,2,2,2,2,2,2,2
2,2,2,2,2,2,2,2,2,2,2,2,2,2,2,2,2,2,2,2
2,2,2,2,2,2,2,2,2,2,2,2,2,2,2,2,2,2,2,2
